0 0 0 0 0 0 0 0 0 0 0 0 0 0 0 0 0 0 0 0
0 0 0 0 0 0 0 0 0 0 0 0 0 0 0 0 0 0 0 0
0 0 0 0 0 0 0 0 0 0 0 0 0 0 0 0 0 0 0 0
0 0 0 0 0 0 0 0 0 0 0 0 0 0 0 0 0 0 0 0
0 0 0 0 0 0 0 0 0 0 0 0 0 0 0 0 0 0 0 0
0 0 0 0 0 0 0 0 0 0 0 0 0 0 0 0 0 0 0 0
0 0 0 0 0 0 0 0 0 0 0 0 0 0 0 0 0 0 0 0
0 0 0 0 0 0 0 0 0 0 0 0 0 0 0 0 0 0 0 0
0 0 0 0 0 0 0 0 0 0 0 0 0 0 0 0 0 0 0 0
0 0 0 0 0 0 0 0 0 0 0 0 0 0 0 0 0 0 0 0
0 0 0 0 0 0 0 0 0 0 0 0 0 0 0 0 0 0 0 0
0 0 0 0 0 6 0 0 0 4 0 0 0 0 0 0 0 0 0 0
0 0 0 0 5 1 3 3 3 1 7 0 0 0 0 0 0 0 0 0
0 0 0 0 0 2 0 0 0 2 0 0 0 0 0 0 0 0 0 0
0 6 0 0 0 2 0 0 0 2 0 0 0 0 0 0 0 0 0 0
5 1 3 3 3 1 7 0 0 2 0 0 0 0 0 0 0 0 0 0
0 2 0 4 0 2 0 0 0 2 0 0 0 0 0 0 0 0 0 0
0 2 0 2 0 2 0 0 0 2 0 0 0 0 0 0 0 0 0 0
5 1 3 1 7 2 0 0 0 2 0 0 0 0 0 0 0 0 0 0
0 6 0 6 5 1 3 3 3 1 7 0 0 0 0 0 0 0 0 0
